9 9 9 9 9 10 2 2 2 2 2 2 2 2 2 2 2 2 2 2 2 2 2 2 2 2 2 2 2 2 2 2 9 10 10 10 10 10
9 9 9 9 9 10 2 2 2 2 2 2 2 2 2 2 2 2 2 2 2 2 2 2 2 2 2 2 2 2 2 2 9 10 10 10 10 10
9 9 9 9 9 10 2 2 2 2 2 2 2 2 2 2 2 2 2 2 2 2 2 2 2 2 2 2 2 2 2 2 9 10 10 10 10 10
9 9 9 9 9 10 3 3 3 3 3 3 3 3 3 3 3 3 3 3 3 3 3 3 3 3 3 3 3 3 3 3 9 10 10 10 10 10
9 9 9 9 9 10 3 3 3 3 3 3 3 3 3 3 3 3 3 3 3 3 3 3 3 3 3 3 3 3 3 3 9 10 10 10 10 10
9 9 9 9 9 10 3 3 3 3 3 3 3 3 3 3 3 3 3 3 3 3 3 3 3 3 3 3 3 3 3 3 9 10 10 10 10 10
9 9 9 9 9 10 3 3 3 3 3 3 3 3 3 3 3 3 3 3 3 3 3 3 3 3 3 3 3 3 3 3 9 10 10 10 10 10
9 9 9 9 9 10 4 4 4 4 4 4 4 4 4 4 4 4 4 4 4 4 4 4 4 4 4 4 4 4 4 4 9 10 10 10 10 10
9 9 9 9 9 10 4 4 4 4 4 4 4 4 4 4 4 4 4 4 4 4 4 4 4 4 4 4 4 4 4 4 9 10 10 10 10 10
9 9 9 9 9 10 4 4 4 4 4 4 4 4 4 4 4 4 4 4 4 4 4 4 4 4 4 4 4 4 4 4 9 10 10 10 10 10
9 9 9 9 9 10 5 5 5 5 5 5 5 5 5 5 5 5 5 5 5 5 5 5 5 5 5 5 5 5 5 5 9 10 10 10 10 10
9 9 9 9 9 10 5 5 5 5 5 5 5 5 5 5 5 5 5 5 5 5 5 5 5 5 5 5 5 5 5 5 9 10 10 10 10 10
9 9 9 9 9 10 6 6 6 6 6 6 6 6 6 6 6 6 6 6 6 6 6 6 6 6 6 6 6 6 6 6 9 10 10 10 10 10
7 7 7 7 7 7 11 11 11 11 11 11 11 11 11 11 11 11 11 11 11 11 11 11 11 11 11 11 11 11 11 11 7 7 7 7 7 7
7 7 7 7 7 7 1 0 0 1 0 0 8 0 0 0 1 0 0 8 1 0 1 0 0 1 0 0 0 0 0 0 7 7 7 7 7 7
7 7 7 7 7 7 0 1 0 8 0 0 1 0 1 0 0 8 0 0 0 0 0 1 0 0 0 0 1 0 1 0 7 7 7 7 7 7
7 7 7 7 7 7 0 0 0 0 0 0 8 0 1 0 0 0 0 1 0 0 1 0 0 0 0 0 0 1 0 0 7 7 7 7 7 7
7 7 7 7 7 7 0 1 8 0 1 0 0 0 0 8 1 0 0 0 0 8 0 0 0 1 0 0 8 0 0 0 7 7 7 7 7 7
7 7 7 7 7 7 8 0 0 1 0 0 0 0 0 0 0 0 1 0 0 0 0 1 8 0 0 1 0 0 1 0 7 7 7 7 7 7
7 7 7 7 7 7 0 0 0 0 8 0 0 1 0 0 0 0 0 0 0 1 0 8 0 1 0 0 0 0 0 0 7 7 7 7 7 7
7 7 7 7 7 7 1 0 0 0 0 0 0 8 0 0 1 0 0 0 1 0 0 0 0 8 0 0 0 0 1 0 7 7 7 7 7 7
7 7 7 7 7 7 0 8 0 1 0 8 0 0 0 0 0 1 0 0 0 0 0 1 0 0 1 0 0 0 0 0 7 7 7 7 7 7
7 7 7 7 7 7 0 0 0 0 0 0 0 0 1 0 8 0 0 1 0 0 0 0 0 0 0 0 8 1 0 0 7 7 7 7 7 7
7 7 7 7 7 7 0 1 0 0 0 1 0 0 0 0 0 0 8 0 0 1 0 1 0 0 0 1 0 0 8 0 7 7 7 7 7 7
7 7 7 7 7 7 0 8 0 0 0 0 0 0 0 0 0 1 1 0 0 0 1 0 0 0 8 0 0 0 0 0 7 7 7 7 7 7
7 7 7 7 7 7 0 0 1 0 0 0 0 0 1 0 0 1 0 0 8 0 0 1 0 0 0 0 8 0 0 0 7 7 7 7 7 7
7 7 7 7 7 7 0 0 0 1 0 0 0 1 0 0 0 0 8 0 0 1 0 0 0 1 0 0 0 1 0 0 7 7 7 7 7 7
7 7 7 7 7 7 1 0 0 0 0 0 8 0 0 0 1 0 0 0 1 0 8 0 0 8 0 0 0 1 0 0 7 7 7 7 7 7
7 7 7 7 7 7 0 0 0 1 0 0 0 0 0 0 0 0 1 0 0 0 0 1 0 0 0 1 8 0 1 0 7 7 7 7 7 7
7 7 7 7 7 7 0 0 0 8 0 0 0 1 0 0 0 8 0 0 0 1 0 0 0 1 0 0 0 1 0 0 7 7 7 7 7 7
7 7 7 7 7 7 1 0 0 0 1 0 0 0 0 0 1 0 0 0 1 0 0 1 0 0 8 0 0 0 0 0 7 7 7 7 7 7
7 7 7 7 7 7 0 0 0 1 0 0 0 8 0 0 0 0 0 0 0 0 0 0 0 0 0 0 1 0 8 0 7 7 7 7 7 7
7 7 7 7 7 7 0 1 0 0 0 1 0 0 1 0 0 0 0 0 0 1 0 0 1 0 0 1 0 0 0 1 7 7 7 7 7 7
7 7 7 7 7 7 0 0 0 0 0 0 0 0 0 0 0 0 1 0 0 0 1 0 8 0 1 0 0 0 1 0 7 7 7 7 7 7
7 7 7 7 7 7 0 0 1 0 0 1 0 0 0 1 0 0 0 0 0 0 0 0 0 1 0 0 0 0 0 0 7 7 7 7 7 7
7 7 7 7 7 7 1 0 0 0 8 0 0 1 0 0 0 0 1 0 0 0 0 0 0 0 0 0 8 1 0 1 7 7 7 7 7 7
7 7 7 7 7 7 0 1 0 0 1 0 0 0 0 0 1 0 0 0 0 0 1 0 0 0 1 0 0 0 0 0 7 7 7 7 7 7
7 7 7 7 7 7 0 0 0 1 0 0 0 0 0 0 0 0 1 0 0 0 0 1 0 0 0 1 0 0 1 0 7 7 7 7 7 7
7 7 7 7 7 7 0 0 0 0 0 8 0 1 0 0 0 0 0 0 0 1 0 0 0 0 0 1 0 0 0 0 7 7 7 7 7 7
7 7 7 7 7 7 1 8 0 0 0 0 0 0 0 0 1 0 0 0 1 0 0 0 1 0 0 0 0 0 0 1 7 7 7 7 7 7
7 7 7 7 7 7 0 0 0 1 0 8 0 0 0 0 0 0 1 0 0 0 0 0 0 0 1 0 0 0 0 1 7 7 7 7 7 7
7 7 7 7 7 7 0 0 0 0 0 0 0 1 0 1 0 0 0 0 0 1 0 0 1 0 0 1 0 0 0 0 7 7 7 7 7 7
7 7 7 7 7 7 1 0 0 0 0 0 1 0 0 0 1 0 0 0 1 0 0 0 0 0 0 0 0 0 0 1 7 7 7 7 7 7
7 7 7 7 7 7 0 0 8 1 0 0 0 0 0 0 0 0 8 0 0 0 0 0 0 0 0 0 0 0 1 0 7 7 7 7 7 7
7 7 7 7 7 7 0 1 0 0 0 1 0 0 0 0 8 0 0 0 0 1 0 0 0 0 1 0 0 0 1 0 7 7 7 7 7 7
7 7 7 7 7 7 0 0 0 0 0 0 0 0 0 0 0 0 1 0 0 0 1 0 0 0 1 0 0 0 1 0 7 7 7 7 7 7
7 7 7 7 7 7 0 0 1 0 0 1 0 0 0 1 0 0 0 0 0 0 1 0 0 1 0 0 0 0 0 0 7 7 7 7 7 7
7 7 7 7 7 7 1 0 0 0 0 0 0 1 0 0 0 0 1 0 1 0 0 0 0 0 0 0 0 0 1 0 7 7 7 7 7 7
7 7 7 7 7 7 0 0 0 0 0 0 0 0 1 0 0 0 0 1 0 0 0 1 0 0 0 8 0 0 0 0 7 7 7 7 7 7
7 7 7 7 7 7 0 1 0 0 0 1 0 0 0 0 0 0 0 0 0 1 1 0 0 0 0 0 0 8 0 0 7 7 7 7 7 7
7 7 7 7 7 7 0 0 0 0 0 0 8 0 0 0 0 0 1 0 0 0 0 0 0 1 0 0 8 0 0 0 7 7 7 7 7 7
7 7 7 7 7 7 0 0 1 0 0 1 0 0 0 1 0 0 0 0 0 0 1 1 0 0 0 0 1 0 0 1 7 7 7 7 7 7
7 7 7 7 7 7 1 0 0 0 0 0 0 1 0 0 0 0 1 0 8 0 1 0 0 0 0 0 0 1 1 0 7 7 7 7 7 7
7 7 7 7 7 7 0 1 0 0 1 0 0 0 0 0 1 0 0 0 0 0 0 0 0 1 0 1 0 0 0 0 7 7 7 7 7 7
7 7 7 7 7 7 0 0 0 1 0 0 0 0 0 0 0 0 1 0 0 0 0 1 8 0 0 1 0 0 0 0 7 7 7 7 7 7
7 7 7 7 7 7 0 0 0 0 0 8 0 1 0 0 0 0 0 0 0 1 0 0 1 0 0 0 0 0 0 0 7 7 7 7 7 7
7 7 7 7 7 7 1 0 0 0 0 0 0 0 0 0 1 0 8 0 1 0 0 0 0 1 0 0 0 0 8 0 7 7 7 7 7 7
7 7 7 7 7 7 0 0 0 0 0 0 0 0 1 0 0 0 0 1 0 0 0 1 0 0 0 1 0 0 0 0 7 7 7 7 7 7
7 7 7 7 7 7 0 0 1 0 0 1 0 0 0 1 0 0 0 0 0 0 1 0 0 0 0 0 0 1 0 0 7 7 7 7 7 7
7 7 7 7 7 7 0 1 0 0 1 0 8 0 0 0 1 0 0 0 0 0 0 0 0 0 0 8 0 1 0 0 7 7 7 7 7 7
7 7 7 7 7 7 0 0 0 0 0 0 0 1 0 0 0 0 8 0 0 1 0 0 1 8 0 0 0 0 0 0 7 7 7 7 7 7
7 7 7 7 7 7 0 0 1 0 0 1 0 0 0 1 0 0 0 0 0 0 1 0 8 1 0 0 0 0 0 0 7 7 7 7 7 7
7 7 7 7 7 7 1 0 0 0 0 0 0 0 0 1 0 1 0 0 0 0 0 0 0 0 0 0 1 0 0 0 7 7 7 7 7 7
7 7 7 7 7 7 0 0 0 1 0 0 0 0 0 0 0 0 1 0 0 0 0 1 0 0 0 1 0 0 0 0 7 7 7 7 7 7
7 7 7 7 7 7 7 7 7 7 7 7 7 7 7 7 7 7 7 7 7 7 7 7 7 7 7 7 7 7 7 7 7 7 7 7 7 7
7 7 7 7 7 7 7 7 7 7 7 7 7 7 7 7 7 7 7 7 7 7 7 7 7 7 7 7 7 7 7 7 7 7 7 7 7 7
7 7 7 7 7 7 7 7 7 7 7 7 7 7 7 7 7 7 7 7 7 7 7 7 7 7 7 7 7 7 7 7 7 7 7 7 7 7
7 7 7 7 7 7 7 7 7 7 7 7 7 7 7 7 7 7 7 7 7 7 7 7 7 7 7 7 7 7 7 7 7 7 7 7 7 7
7 7 7 7 7 7 7 7 7 7 7 7 7 7 7 7 7 7 7 7 7 7 7 7 7 7 7 7 7 7 7 7 7 7 7 7 7 7
7 7 7 7 7 7 7 7 7 7 7 7 7 7 7 7 7 7 7 7 7 7 7 7 7 7 7 7 7 7 7 7 7 7 7 7 7 7